-------------------
-----R-------------
---FFFFFFR---------
----C----F-----C---
----------H--------
---C-----FFFF---C--
-------------------
----C---------C----
J-----------------J
TTTTTTTTTTTTTTTTTTT
