EEEEEEEEEEEEEEEEEEE
EEEEEEEEEEEEEEEEEEE
EEEEEEEEEEEEEEEEEEE
TTTTTTTTTTTTTTTTTTT
EEEEEEEPEEEEEEEEEEE
TTTTTTTTTTTTTTTTTTT
EEEEEEEEEEEEEEEEPEE
TTTTTTTTTTTTTTTTTTT
EEEEEEEEEHEEEEEEEEE
TTTTTTTTTTTTTTTTTTT
