--T---T------R------
---T-T-TTT-T-T-----
----T--T-T-T-T-----
----T--TTT-TTT-----
--------H----------
--T-T-T-T-TTT------
--T-T-T-T-T-T------
--TTTTT-T-T-T------
-------------------
-------------------
