-------------------
-------------------
-------------------
-------------------
-----R-------T-----
----TTTT----H------
-----------TTT-----
-------------------
--D----------------
TTTTTTTTTTTTTTTTTTT
