EEEEEEEEEEEEEEEEEEE
EEEEEEEEEEEEEEEEEEE
EEEEEEEEEEEEEEEEEEE
EEEEEEEEHEEEEEEEEEE
EEEEEEEEEEEEETEEEEE
EEEETTTTEEEEEEEEEEE
EEEEEEEEEEETTTEEEEE
EEEEEEEEEEEEEEEEEEE
RRRRRRRRRRRRRRRRRRR
TTTTTTTTTTTTTTTTTTT
