---------H---------
--------FFFF--M----
---M---------------
-------------------
-----------M-------
-------------------
-------------------
--M----------------
------------------
TTTTTTTTTTTTTTTTTTT
