EEEEEEEEEE
EEEEEEEEEE
EHEEEEEEEE
EEEEEEEEEE
EEEEEEEEEE
EEEEEEEEEE
EEEEEEEEEE
EEEEETTEEE
EEEEEEEEEE
TTTTTTTTTT
