EEEEEEEEEEEEEEEEEEE
TEEEEEETTTEEEEEEEEE
EEETTTEEEETTTTTTEET
TEEEEEEEEEEEEEEEEEE
EEEETTTTTEEEEEEEEEE
EEEEEEEEEEEEEEEEEEE
TTTTTTTTTTTTTTTTTTT
EEEEEEEEEEEEEEEEEEE
EJEEJEJEEHEEEJEJEJE
TTTTTTTTTTTTTTTTTTT
