EEEEEEEEEEEEEEEEEEE
EEREEEEEEEEEEEEPEEE
EETEEEEEEETTEEEEEEE
EEEEPEEEEEEEEEEEEEE
EEEEEEEEEEEEEEDEEEE
TTTTTTTTTTTTTTTTTTT
EEEEEEEEEEEEEEEEEEE
EEEEEEEEEEEEEEEEEEE
EEEEEHEEEEEEEEEEEEE
TTTTTTTTTTTTTTTTTTT
