EEEEEEEEEEEEEEEEEEE
EEEEEEEEEEEEEEEEEEE
EEEEEDEEEEEEEEEEEEE
EEEEEEEEHEEEEEEEEEE
EEEEEEEEEEEEETEEEEE
EEEETEEEEEEEEREEEEE
EEEEEEEEEEETTTEEEEE
EEEEEEEEEEEEEEEEEEE
EEREEEEEEEEEEEEEEEE
TTTTTTTTTTTTTTTTTTT
