EEEEEEEEET
EEEEEEEEEE
EEEEEEEETE
EEEEHEEEEE
EEEEEEEEEE
EEEEEEEDEE
EEEEDTEEEE
EEEEEEEEEE
EEEEEEEEEE
TTTTTTTTTT
