EEEEEEDEEEEEEEEEEEE
EEEEEEEEEEEEEEREEEE
EECEEEEEEREEETTTTTT
EEEEEEEEETEEEEEEEEE
EEEEEEEEEETEEEEEEPE
EEEEEEEEEEEETEEEEEE
EEREEEEEEEEEEEEEEEE
EETTTTEEEEEEEEEEEEE
EEEEEEEEEEEHEEEEEEE
TTTTTTTTTTTTTTTTTTT
