------------D------
---TRT-------------
----T------------D-
--TT---------------
--------H----------
-------TTTT--------
---------------D---
-----------TTT-----
-------------------
TTTTTTTTTTTTTTTTTTT
