------D------------
--------------R----
--C------R---TTTTTT
---------T---------
----------T------P-
------------T------
--R----------------
--TTTT-------------
-----------H-------
TTTTTTTTTTTTTTTTTTT
