EEEEREEEEEEEREEEEEE
EEERTREEEEERTREEEEE
EERTETREEERTETREEEE
ERTEEETRERTEEETREEEE
RTEEEEETRTEEEEETREE
TEEEEEEETEEEEEEETRE
EEEEEEEEEEEEEEEEETR
TEEEEEEEEEEEEEEEEET
EEEEEEEEHEEEEEEEEEE
TTTTTTTTTTTTTTTTTTT
