EEEEEEEEDE
EHEEEEEEEE
EEEEEEEEE
EEEEEEEDEE
EEEEEEEEEE
EEEEEEEEEE
EEEDETTEEE
EEEEEEEEEE
EEEEEEEEEE
TTTTTTTTTT
