-------------------
----TRT------------
-----T-C-----------
----------TTT------
-------------------
------------H------
-----------TTT-----
-----C-------------
-------------------
TTTTTTTTTTTTTTTTTTT
