EEEEEEEEEEEEEEEEEEE
EEEEEEEEEEEEEEEEEEE
EEEEEEEEEEEEEEEEEEE
EEEEEEEEEEEEEEEEEEE
EEEEEEEEEEETTTEEEEE
EEETTTTTEEEEEEEEEEE
TTTTEEEEEEETTTEEEEE
TEEEEEEEEEEEEEEEEEE
TEEEEEEEHEEEEEEEEEE
TTTTTTTTTTTTTTTTTTT
