EEEEEEEEEEEEEEEEEEM
EEEEEEEEEEEEEEEEEEE
EEEEEMEEEEEEEEEEEEE
EEEEEEEEEEEEEEEEEEE
EEEEEEEEEEETTTEEEEE
EEEEETTTEEEEEEEEEEE
TTTTEEEEEEETTTEEEEE
EEEEEEEEEEEEEEEEEEE
EEEEEEEEHEEEEEEEEEE
TTTTTTTTTTTTTTTTTTT
