EEEEEEEEEEEEEEEEEEE
EEEEEEEEHEEEEEEEEEE
EEEEEEETTTEEEEEEEEE
EEEEEEEEEEEEEEEEEEE
EEEEPEEEEEREEEEEEED
EEEETEEETTTTEEEEEEE
EEEEEEEEEEEEEEEEEEE
EEEEEEEEEEEEEEEEEEE
EEEEEEEEEEEEEEEEEEE
TTTTTTTTTTTTTTTTTTT
