----R-------R------
---RFR-----RFR-----
--RF-FR---RF-FR----
-RF---FR-RF---FR----
RF-----FRF-----FR--
F-------F-------FR-
-----------------FR
F-----------------F
--------H----------
TTTTTTTTTTTTTTTTTTT
