EEECEEEEEEEECEEEEEE
EEEEEEEEEEEEEEEEEEE
EEEEJEEEEEEEEEPEEEE
EEETTTEEEEEEEEEEEEE
EPEEEEEEPEEEEEEEEEE
EEEEEEEEEEEEEEJEEEE
EEEEJEEEEEEEETTTEEE
EEETTTEEEEEEEEEEEEE
EEEEEEEEEEHEEEEEEEE
TTTTTTTTTTTTTTTTTTT
