-------------------
-------------------
-------------------
------------R------
-----------TTT-----
--R--TTT-----------
TTTT-------TTT-----
-------------------
-D------H---------D
TTTTTTTTTTTTTTTTTTT
