-------------------
---------H---------
--------FFF--------
-FFF---------------
---------C----FFF--
--FFF--------------
---------------FFF-
F--F-------FFF-----
-------------------
TTTTTTTTTTTTTTTTTTT
