EEEEEREEEEEEDEEEEEE
EEETTTEEEEEEEEEEEEE
EEEEEEEEEEEEEEEEEDE
EETEEEEEEEEEEEEEEEE
EEEEEEEEHEEEEEEEEEE
EEEEEEETTTTEEEEEEEE
EEEEEEEEEEEEEEEDEEE
EEEEEEEEEEETTTEEEEE
EEEEEEEEEEEEEEEEEEE
TTTTTTTTTTTTTTTTTTT
