-------------------
---M---------------
-------R-----------
-----FFFFF---------
---------D-----J---
--------------FFFFF
--H----------------
-FFFFF-------------
----------------J--
TTTTTTTTTTTTTTTTTTT
