----R-------R------
---RTR-----RTR-----
--RT-TR---RT-TR----
-RT---TR-RT---TR----
RT-----TRT-----TR--
T-------T-------TR-
-----------------TR
T-----------------T
--------H----------
TTTTTTTTTTTTTTTTTTT
