-------------------
----TTTT------------
-------C---------C-
-------------------
-------------------
------------H------
-----------TTT-----
-----C-------------
-------------------
TTTTTTTTTTTTTTTTTTT
