EEEEEEEEEEEEEEEEEEE
EEEETTTTEEEEEEEEEEEE
EEEEEEECEEEEEEEEECE
EEEEEEEEEEEEEEEEEEE
EEEEEEEEEEEEEEEEEEE
EEEEEEEEEEEEHEEEEEE
EEEEEEEEEEETTTEEEEE
EEEEECEEEEEEEEEEEEE
EEEEEEEEEEEEEEEEEEE
TTTTTTTTTTTTTTTTTTT
