-------------------
-------------P-----
-------TTT---------
-------------------
---------H---------
----T---TTTT-------
-------------------
-------------------
---D---------------
TTTTTTTTTTTTTTTTTTT
