EEEEEEEEEEEEEEEEEEE
EEEEEEEEEEEEEEEEEEE
EEEEEEEEEEEEEEEEEEE
EEEEEEEEHEEEEEEEEEE
EEEEREEEEEEEEESEEEEE
EEEETEEEEEEEEREEEEE
EEEEEEEEREEEEEEEEEE
EEEEEEEEEEEEEEEEEEE
EEREEEEEEEEEEEEEEEE
TTTTTTTTTTTTTTTTTTT
