EEEEEEEEEEEEEEEEEEE
EEEEEEEEEEEEEEEEEEE
EEETTTEEEEEEEEEJEEE
EEEEEEEEEEEEEETTTTTE
EEEEETTTEEEEJEEEEEE
EEEEEEEEEEETTTEEEEE
EEEEEEJEEEEEEEEETTE
EEEEETTTEEEEEEEEEEE
EEJEEEEEEEEEHEEEEEE
TTTTTTTTTTTTTTTTTTT
