-----R------D------
---TTT-------------
-----------------D-
--T----------------
--------H----------
-------TTTT--------
---------------D---
-----------TTT-----
-------------------
TTTTTTTTTTTTTTTTTTT
