TEEETEEEEEEEEEEEEEE
ETETEETTTEETETEEEEE
EETEEETETEETETEEEEE
EETEEETTTEETTTEEEEE
TEEEEEEEEEEEEETTTEE
TEEETTTETTTEETEEEEE
TEEETETEEETEETTTEEE
TTTETTTETTTEETEEEEE
EEEEEEEEEEEEETTTEEE
TTTTTTTTTTTTTTTTTTT
