-------------------
-------------------
-------J-----------
------TTT----------
-------------------
------------J------
-TTT-TTT----TTT-TTT
----T----------T---
---CC----H-----CC--
TTTTTTTTTTTTTTTTTTT
