EEEEEEEEEEEEEEEEEEE
EEEEEEEEEEEEEEEEEEE
EEEEEPEEEEEEEEEEEEE
EEEEEEEEEEEEEEEEEEE
EEEEEEEEEEETTTEEEEE
EEEEETTTEEEEEEEEEEE
TTTTEEEEEEETTTEEEEE
EEEEEEEEEEEEEEEEEEE
EEEEEEEEHEEEEEEEEEE
TTTTTTTTTTTTTTTTTTT
