-------------------
----FRF------------
-----F-C-----------
----------FFF------
-------------------
------------H------
-----------FFF-----
-----C-------------
-------------------
TTTTTTTTTTTTTTTTTTT
