EEEEDEEEEDEEEEEEEEE
EEEEEEEEEEEEEEEEEEE
EEEEEEEEEEEEEEEEEEE
EEEEEEEEHEEEEEEEEEE
EEEEEREEEEEEETEEEEE
EEEETTTTEEEEEEEEEEE
EEEEEEEEEEETTTEEEEE
EEEEEEEEEEEEEEEEEEE
EEEEEEEEEEEEEEEEEEE
TTTTTTTTTTTTTTTTTTT
