EEEEEEEEEE
TEEEEEEEEE
TEEEEEEEEE
THEEEEEEE
TTTTTEEEEE
EEEEEEEEEE
EEEEETTTEE
EEEEEEEEEE
EEEEEEEEEE
TTTTTTTTTT
