-------------------
----C--------------
-R-----R-----R-----
FFFFFFFFFFFFFFFFFFF
---C-------C-------
-R------R----R-----
FFFFFFFFFFFFFFFFFFF
-------------------
------H------------
TTTTTTTTTTTTTTTTTTT
