-------------------
----FRF------------
-----F-D-----------
----------FFF------
-------------------
------------H------
-----------FFF-----
-----D-------------
-------------------
TTTTTTTTTTTTTTTTTTT
