-------------------
-------------------
---FFF---------J---
--------------FFFF-
-----FFF----J------
-----------FFF-----
------J---------FF-
-----FFF-----------
--J---------H------
TTTTTTTTTTTTTTTTTTT
