---C--------C------
-------------------
----J---------P----
---FFF-------------
-P------P----------
--------------J----
----J--------FFF---
---FFF-------------
----------H--------
TTTTTTTTTTTTTTTTTTT
