-------------------
-------------------
---TTT---------J---
--------------TTTTT-
-----TTT----J------
-----------TTT-----
------J---------TT-
-----TTT-----------
--J---------H------
TTTTTTTTTTTTTTTTTTT
