-------------------
-----R-------------
---TTTTTTR---------
----C----T-----C---
----------H--------
---C-----TTTT---C--
-------------------
----C---------C----
J-----------------J
TTTTTTTTTTTTTTTTTTT
