-------------------
----C--------------
-R-----R-----R-----
TTTTTTTTTTTTTTTTTTT
---C-------C-------
-R------R----R-----
TTTTTTTTTTTTTTTTTTT
-------------------
------H------------
TTTTTTTTTTTTTTTTTTT
