EEEEEEEEEEEEEEDEEEE
EEEEEEEEEEEEEEEEEEE
EEEEEEETTTEEEEEEEEE
EEEEEEEEEEEEEEEEEEE
EEEEEEEEEHEEEEEEEEE
EEEETEEETTTTEEEEEEE
EEEEEEEEEEEEEEEEEEE
EEEEEEEEEEEEEEEEEEE
EEEEEEEEEEEEEEEEEEE
TTTTTTTTTTTTTTTTTTT
