---------H----------
--------TTTT--M-----
---M---------------
-------------------
-----------M-------
-------------------
-------------------
--M----------------
-------------------
TTTTTTTTTTTTTTTTTTT
