-------------------
-------------------
-------------------
TTTTTTTTTTTTTTTTTTT
-------P-----------
TTTTTTTTTTTTTTTTTTT
----------------P--
TTTTTTTTTTTTTTTTTTT
---------H---------
TTTTTTTTTTTTTTTTTTT
