T---T--------------
-T-T--TTT--T-T-----
--T---T-T--T-T-----
--T---TTT--TTT-----
T-------------TTT--
T---TTT-TTT--T-----
T---T-T---T--TTT---
TTT-TTT-TTT--T-----
-------------TTT---
TTTTTTTTTTTTTTTTTTT
