EEEEEEEEEEEEEEEEEEE
EEEEEEEEHEEEEEEEEEE
EEEEEEEEEEEEEEEEEEE
EEEEEEEEEEEEEEEEEEE
EEEEEEEEEEEEEEEEEEE
EEEETEEETTTTEEEEEEE
EEEEEEEEEEEEEEEEEEE
EEEEEEEEEEEEEEEEEEE
EDEEDEEEEEEEEEDEEEE
TTTTTTTTTTTTTTTTTTT
