---C--------C------
-------------------
----J---------P----
---TTT-------------
-P------P----------
--------------J----
----J--------TTT---
---TTT-------------
----------H--------
TTTTTTTTTTTTTTTTTTT
