-------------------
---M---------------
-------R-----------
-----TTTTT---------
---------C-----J---
--------------TTTTT
--H----------------
-TTTTT-------------
----------------J--
TTTTTTTTTTTTTTTTTTT
