EEEEEEEEEEEEEEEEEEE
EEEECEEEEEEEEEEEEEE
EREEEEEREEEEEREEEEE
TTTTTTTTTTTTTTTTTTT
EEECEEEEEEECEEEEEEE
EREEEEEEREEEEREEEEE
TTTTTTTTTTTTTTTTTTT
EEEEEEEEEEEEEEEEEEE
EEEEEEHEEEEEEEEEEEE
TTTTTTTTTTTTTTTTTTT
