EEEEEEEEEEEEEEEEEEE
EEEEEEEEEEEEEEEEEEE
EEEEEEEEEEEEEEEEEEE
EEEEEEEEEEEEEEEEEEE
EEEEEEEEEEEEEEEEEEE
EEEEEEEEEEEEEEEEEEE
EEEEEEEETTTTTTTTTEE
EEEEEEEEEEEEEEEEEEE
EEHEEEEEEEEEEEEEEEE
TTTTTTTTTTTTTTTTTTT
