HEEHTTTTTT
EEEEEEEEEE
EHEEEEHEEE
EEEEHEEEEE
EEEEEEEEEE
EEEEHEEEEE
EEEEEEEEEE
EEHEEEEEEE
EEEEEEEEHE
HEEEEEEEEE
