EREEEEEEEEEEEEEEEEE
EEEEEEEEEDEEEEEEEEE
EEEEEDEEEEEEEEEREEE
EEEEEEEEHEEEEEEEEEE
EEEEEEEEEEEEETEEEEE
EEEETTTTEEEEEEEEEEE
EEEEEEEEEEETTTEEEEE
EEEEEEEEEEEEEEEEEEE
EEREEEEEEEEEEEEEEEE
TTTTTTTTTTTTTTTTTTT
