-----------M-------
F------FFF---------
---FFF----FFFFFF--F
F------------------
----FFFFF----------
-------------------
FFFFFFFFFFFFFFFFFFF
-------------------
-J--J-J--H---J-J-J-
TTTTTTTTTTTTTTTTTTT
