EEEEEREEEEEEEEEEEEE
EEEEETEEEEEREEEEEEE
EEEEEEEEEEETEEEEEEE
EEEREEEEEEEEEEEEDEE
EEETEEEEEEEEEEEEEEE
EEEEEEEEEEEEEEEEEEE
EDEEEEEEEEEEEEEEERE
EEEEEEEEEEEEEEEEETE
EEEEEEEEEHEEEEEEEEEE
TTTTTTTTTTTTTTTTTTT
