EEEEEEEEEEEEEEEEEEE
EEEEEEEEHEEEEEEEEEE
EEEEEEETTTEEEEEEEEE
EEEEEEEEEEEEEEEEEEE
EEEEEEEEEEREEEEEEED
EEEETEEETTTTEEEEEEE
EEEEEEEEEEEEEEEEEEE
EEEEEEEEEEEEEEEEEEE
EEEEEEEEEEEEEEEEEEE
TTTTTTTTTTTTTTTTTTT
