EEEDEEEEEEEEEEEEEEE
EEETTTEEEEEEEEEPEEE
EEEEEEEEEEEEEEEEEEE
EETEEEEEEEEEEEEEEEE
EEEEEEEEHEEEEEEEEPE
EEEEEEETTTTEEEEEEEE
EEEEEEEEEEEEREEEEEE
EEEDEEEEEEETTTEEEEE
EEEEEEEEEEEEEEEEEEE
TTTTTTTTTTTTTTTTTTT
