-------------------
--R------------P---
--T-------TT-------
----P--------------
--------------D----
TTTTTTTTTTTTTTTTTTT
-------------------
-------------------
-----H-------------
TTTTTTTTTTTTTTTTTTT
