-------------------
-------------------
----------------R--
TTTTTTTTTTTTTTTTTTT
-------P----R------
TTTTTTTTTTTTTTTTTTT
-----D----------P--
TTTTTTTTTTTTTTTTTTT
---------H---------
TTTTTTTTTTTTTTTTTTT
