EEEEEEEEEEEEEEEEEEE
EEEEEEEEEEEEEEEEEEE
EEEEEEEEEEEEEEEEEEE
EEEEEEEEEEEEEEEEEEE
EEEEEREEEEEEETEEEEE
EEEETTTTEEEEHEEEEEE
EEEEEEEEEEETTTEEEEE
EEEEEEEEEEEEEEEEEEE
EEDEEEEEEEEEEEEEEEE
TTTTTTTTTTTTTTTTTTT
