EEEEEEEEEEEEEEEEEEE
EEEEEEEEEEEEEEEEEEE
EEEEEEEJEEEEEEEEEEE
EEEEEETTTEEEEEEEEEE
EEEEEEEEEEEEEEEEEEE
EEEEEEEEEEEEJEEEEEE
ETTTETTTEEEETTTETTT
EEEETEEEEEEEEEETEEE
EEECCEEEEHEEEEECCEE
TTTTTTTTTTTTTTTTTTT
