EEEEDEEEEEEEDEEEEEE
EEEEEEEEHEEEEEDEEEE
EEEEEEEEEEEEEEEEEEE
EEEEEEEEEEEEEEEEEEE
EEEEREEEEREEEESEEEEE
EEEETEEETTTTEREEEEE
EEEEEEEEREEEEEEEEEE
EEEEEEEEEEEEEEEEEEE
EEREEEEEEEEEEEEEEEE
TTTTTTTTTTTTTTTTTTT
