-------------------
--------M----------
-------------------
-------------------
-R--R-------R--R---
FFFFFFFF--FFFFFFFFF
---------------H---
--------------FF---
----M--------------
TTTTTTTTTTTTTTTTTTT
