-----R-------------
-----T-----R-------
-----------T-------
---R------------D--
---T---------------
-------------------
-D---------------R-
-----------------T-
---------H----------
TTTTTTTTTTTTTTTTTTT
