------------D------
---FRF-------------
----F------------D-
--FF---------------
--------H----------
-------FFFF--------
---------------D---
-----------FFF-----
-------------------
TTTTTTTTTTTTTTTTTTT
