-----------M-------
T------TTT---------
---TTT----TTTTTT--T
T------------------
----TTTTT----------
-------------------
TTTTTTTTTTTTTTTTTTT
-------------------
-J--J-J--H---J-J-J-
TTTTTTTTTTTTTTTTTTT
