EEEEEEEEEE
EHEEEEEEEE
EEEEEREEE
EEEEEEEEEE
EEDEEEEEEE
EEEEEEEEEE
EEEEETTEEE
EEEEEEEEEE
EEEEEEEEEE
TTTTTTTTTT
