-------------------
--------M----------
-------------------
-------------------
-R--R-------R--R---
TTTTTTTT--TTTTTTTTT
---------------H---
--------------TT---
----M--------------
TTTTTTTTTTTTTTTTTTT
