-------------------
----D----D-----D---
-R-----R-----R-----
FFFFFFFFFFFFFFFFFFF
---D-------D---D---
-R------R----R-----
FFFFFFFFFFFFFFFFFFF
-------------------
------H------------
TTTTTTTTTTTTTTTTTTT
