EEEEEEEEEEEEEEEEEEE
EEEEEEEEMEEEEEEEEEE
EEEEEEEEEEEEEEEEEEE
EEEEEEEEEEEEEEEEEEE
EREEREEEEEEEREEREEE
TTTTTTTTEETTTTTTTTT
EEEEEEEEEEEEEEEHEEE
EEEEEEEEEEEEEETTEEE
EEEEMEEEEEEEEEEEEEE
TTTTTTTTTTTTTTTTTTT
