-------------------
-------------------
-------J-----------
------FFF----------
-------------------
------------J------
-FFF-FFF----FFF-FFF
----F----------F---
---DD----H-----DD--
TTTTTTTTTTTTTTTTTTT
