-------------------
--R------------P---
--F-------FF-------
----P--------------
--------------D----
FFFFFFFFFFFFFFFFFFF
-------------------
-------------------
-----H-------------
TTTTTTTTTTTTTTTTTTT
