-------------------
-------------P-----
-------FFF---------
-------------------
---------H---------
----F---FFFF-------
-------------------
-------------------
---D---------------
TTTTTTTTTTTTTTTTTTT
