------D------------
--------------R----
--D------R---FFFFFF
---------F---------
----------F------P-
------------F------
--R----------------
--FFFF-------------
-----------H-------
TTTTTTTTTTTTTTTTTTT
