-------------------
-------------------
-------------------
------------R------
-----------FFF-----
--R--FFF-----------
FFFF-------FFF-----
-------------------
-D------H---------D
TTTTTTTTTTTTTTTTTTT
