-------------------
-------------------
----------------R--
FFFFFFFFFFFFFFFFFFF
-------P----R------
FFFFFFFFFFFFFFFFFFF
-----D----------P--
FFFFFFFFFFFFFFFFFFF
---------H---------
TTTTTTTTTTTTTTTTTTT
