----R-------R------
----F-------F------
--RF-FR---RF-FR----
--F---F---F---F-----
RF-----FRF-----FR--
F-------F-------F--
-----------------FR
F-----------------F
--------H----------
TTTTTTTTTTTTTTTTTTT
