-----R-------------
-----F-----R-------
-----------F-------
---R------------D--
---F---------------
-------------------
-D---------------R-
-----------------F-
---------H----------
TTTTTTTTTTTTTTTTTTT
