-------------------
-------------------
-------------------
-------------------
-----R-------F-----
----FFFF----H------
-----------FFF-----
-------------------
--D----------------
TTTTTTTTTTTTTTTTTTT
