-------------------
---------H---------
--------FFF--------
-FFF---------------
--------------FFF--
--FFF--------------
---------------FFF-
F--F-------FFF-----
--------C----------
TTTTTTTTTTTTTTTTTTT
